NO ./textures/brickwall10.png

SO ./textures/brickwall10.png

WE ./textures/brickwall10.png

EA ./textures/brickwall10.png


F 10,5,0
C 0,0,0

111111111111111111111111111111111111
10000000000000000000000000000000S001
1D1111111D11111101111011111000000001
100000010000000010000010000000000001
101111000001111111101111011111001101
100000000001000000000000010000000001
11111101110111111D1111010111011D1101
100000010000000000010000010000000001
101111111101100000111111110001011101
100000000000010000000000000010000001
101111011111011000101111011111111101
100000010000000000010000010000000001
111111011101111101111101011101111111
100000010000010000000010000010000001
101111111101011111101011111111011101
100000000000010000000010000000000001
111111011111011101111000000011011101
100000010000000000000000000000000001
1011110111011111011111011111D1111101
100000000001000010000000000010000001
111101111111111011111111000001111101
100001000000000000000000000000000001
101111011111011111111111111101111101
100000010000010000000000000010000001
101111011111011111101111111111011101
100000000000000000010000000000000001
111000000000011111111111111111111101
100000000100000000000000000000000001
101000100000111111111111011111111101
100000000000000000000000000000000001
1111011111D1111111011111111111111101
100001000000000000000000000000000001
100000000001111111111111111111111101
1000000000000000D0000000000000000001
101111111111011111111101111111111101
100000000000010000000010000000000001
11110111110101111111111111D111111101
100001000010000000000000000000000001
1011111111110111111000001111111111D1
100000000000010000000000000000000001
1011111111D1111111111111000000000001
1000000000000000000000000000000000X1
111111111111111111111111111111111111
