NO ./path_to_the_north_texture
SO ./path_to_the_south_texture

WE ./path_to_the_west_texture

EA ./path_to_the_east_texture


F 0,66,0
C 225,211,245
        1111111111111111111111111
        1000000000110000000000001
        1011000001110000000000001
        1001000000000000000000001
111111111011000001110000000000001
100000000011000001110111110111111
1111011111111101110000001000111
1111011111111101110101001000001
110000001101010111000000100001
1000000000000000110000001000001
1000000000000000110101001000111
1100000111010101111101111000111
 11110111 1110101 101111010S01
11111111 1111111 111111111111
