NO ./textures/test_wall2.png

SO ./textures/test_wall5.png

WE ./textures/test_wall3.png

EA ./textures/test_wall4.png

aa ./sls


F 0,100,0
C 0,0,200

    
           111111111111111111111111
           1000000000110440000000001
           1011000011110000001000001
           1001000020444400000100001
111111111111000001110000000000001111
100000000011000001112121121111111
11110111111111011100000010001
11112111111111211101010010401
11000000110101011100000010001
10000000000000001100400010001
10000000000000001101010010001
11000001110101011111011110N0111
11110111 1110101 101111010001