NO ./textures/test_wall2.png

SO ./textures/test_wall5.png

WE ./textures/test_wall3.png

EA ./textures/test_wall4.png


F 0,100,0
C 0,0,200

11111111111
11111111111
11000000011
11000000011
11000000011
11000800011
11000N00011
11111111111
11111111111