
NO ./textures/test_wall2.png

SO ./textures/test_wall5.png

WE ./textures/test_wall3.png

EA ./textures/test_wall4.png
F 220,100,0
C 225,30,0

111111111111111111111111111111111111111   
111111111111111111111111111111111111111
110000000000000000111000000000000000011
110000000000000000000000000000000000011
110000000000000000000000000000000000011
110000000000000000000000000000000000011
110000000000100000000000000000000000011
110000000000000000000000001111111111111
110000000000000000000000000000000000011
110000000000000000000000000000000000011
110000000000000000000000000000000000011
110000000000000000000000000000000000011
110000000000000000000000000000000000011
110000000000000000000000000000000000011
110000000000000000000000000000000000011
110000000000000000000000000000000000011
110000000000000000000000000000000000011
110000000000000000000000000000000000011
110000000000000000000000000000000000011
110000000000000000000000000000000000011
110000000000000000000000000000000000011
110000000000000000000000000000000000011
110000000000000000000000000000000000011
110000000000000000000000000000000000011
110000000000000000000111111111111111111
11000000000000000000011
11001110011111111111111
110N1110011
11001110011
11000000011
111111100111
111111100111
111111100111
111111100111
111111100111
111111100111
111111100111
111111100111
111111100111
111111100111
111111100111
111111100111
111111100111
111111100111
111111100111
111111100111
111111100111
111111100111
111111100111
111111100111
111111100111
111111100111111111100111
111111100111
111111100111
111111100111
111111100111
111111100111
111111100111
111111100111
111111100111
111111100111
111111100111111111100111
111111100111
111111100111
111111100111
111111100111
111111100111
111111100111
111111100111
111111100111
111111100111
111111100111
111111100111
111111100111
111111100111
111111100111
111111100111
111111100111
111111100111
111111100111
111111100111
111111100111
111111100111
111111100111
111111100111
111111100111
111111100111111111100111
111111100111
111111100111
111111100111
111111100111
111111100111
111111100111
111111100111
111111100111
111111100111
111111100111111111100111
111111100111
111111100111
111111100111
111111100111
111111100111
111111100111111111100111
111111100111
111111100111
111111100111
111111100111
111111100111
111111100111
111111100111
111111100111
111111100111
111111100111
111111100111
111111100111
111111100111
111111100111
111111100111
111111100111
111111100111
111111100111111111100111
111111100111
111111100111
111111100111
111111100111
111111100111
111111100111
111111100111
111111100111
111111100111
111111100111111111100111
111111100111
111111100111
111111100111
111111100111
111111100111
111111100111111111100111
111111100111
111111100111
111111100111
111111100111
111111100111
111111100111
111111100111
111111100111
111111100111
111111100111
111111100111
111111100111
111111100111
111111100111
111111100111
111111100111
111111100111
111111100111111111100111
111111100111
111111100111
111111100111
111111100111
111111100111
111111100111
111111100111
111111100111
111111100111
111111100111111111100111
111111100111
111111100111
111111100111
111111100111
111111100111
111111100111111111100111
111111100111
111111100111
111111100111
111111100111
111111100111
111111100111
111111100111
111111100111
111111100111
111111100111
111111100111
111111100111
111111100111
111111100111
111111100111
111111100111
111111100111
111111100111111111100111
111111100111
111111100111
111111100111
111111100111
111111100111
111111100111
111111100111
111111100111
111111100111
111111100111111111100111
111111100111
111111100111
111111100111
111111100111
111111100111
111111100111111111100111
111111100111
111111100111
111111100111
111111100111
111111100111
111111100111
111111100111
111111100111
111111100111
111111100111
111111100111
111111100111
111111100111
111111100111
111111100111
111111100111
111111100111
111111100111111111100111
111111100111
111111100111
111111100111
111111100111
111111100111
111111100111
111111100111
111111100111
111111100111
111111100111111111100111
111111100111
111111100111
111111100111
111111100111
111111100111
111111100111111111100111
111111100111
111111100111
111111100111
111111100111
111111100111
111111100111
111111100111
111111100111
111111100111
111111100111
111111100111
111111100111
111111100111
111111100111
111111100111
111111100111
111111100111
111111100111111111100111
111111100111
111111100111
111111100111
111111100111
111111100111
111111100111
111111100111
111111100111
111111100111
111111100111111111100111
111111100111
111111100111
111111100111
111111100111
111111100111
111111100111111111100111
111111100111
111111100111
111111100111
111111100111
111111100111
111111100111
111111100111
111111100111
111111100111
111111100111
111111100111
111111100111
111111100111
111111100111
111111100111
111111100111
111111100111
111111100111111111100111
111111100111
111111100111
111111100111
111111100111
111111100111
111111100111
111111100111
111111100111
111111100111
111111100111111111100111
111111100111
111111100111
111111100111
111111100111
111111100111
111111100111111111100111
111111100111
111111100111
111111100111
111111100111
111111100111
111111100111
111111100111
111111100111
111111100111
111111100111
111111100111
111111100111
111111100111
111111100111
111111100111
111111100111
111111100111
111111100111111111100111
111111100111
111111100111
111111100111
111111100111
111111100111
111111100111
111111100111
111111100111
111111100111
111111100111111111100111
111111100111
111111100111
111111100111
111111100111
111111100111
111111100111111111100111
111111100111
111111100111
111111100111
111111100111
111111100111
111111100111
111111100111
111111100111
111111100111
111111100111
111111100111
111111100111
111111100111
111111100111
111111100111
111111100111
111111100111
111111100111111111100111
111111100111
111111100111
111111100111
111111100111
111111100111
111111100111
111111100111
111111100111
111111100111
111111100111111111100111
111111100111
111111100111
111111100111
111111100111
111111100111
111111100111111111100111
111111100111
111111100111
111111100111
111111100111
111111100111
111111100111
111111100111
111111100111
111111100111
111111100111
111111100111
111111100111
111111100111
111111100111
111111100111
111111100111
111111100111
111111100111111111100111
111111100111
111111100111
111111100111
111111100111
111111100111
111111100111
111111100111
111111100111
111111100111
111111100111111111100111
111111100111
111111100111
111111100111
111111100111
111111100111
111111100111111111100111
111111100111
111111100111
111111100111
111111100111
111111100111
111111100111
111111100111
111111100111
111111100111
111111100111
111111100111
111111100111
111111100111
111111100111
111111100111
111111100111
111111100111
111111100111111111100111
111111100111
111111100111
111111100111
111111100111
111111100111
111111100111
111111100111
111111100111
111111100111
111111100111111111100111
111111100111
111111100111
111111100111
111111100111
111111100111
111111100111111111100111
111111100111
111111100111
111111100111
111111100111
111111100111
111111100111
111111100111
111111100111
111111100111
111111100111
111111100111
111111100111
111111100111
111111100111
111111100111
111111100111
111111100111
111111100111111111100111
111111100111
111111100111
111111100111
111111100111
111111100111
111111100111
111111100111
111111100111
111111100111
111111100111111111100111
111111100111
111111100111
111111100111
111111100111
111111100111
111111100111111111100111
111111100111
111111100111
111111100111
111111100111
111111100111
111111100111
111111100111
111111100111
111111100111
111111100111
111111100111
111111100111
111111100111
111111100111
111111100111
111111100111
111111100111
111111100111111111100111
111111100111
111111100111
111111100111
111111100111
111111100111
111111100111
111111100111
111111100111
111111100111
111111100111111111100111
111111100111
111111100111
111111100111
111111100111
111111100111
111111100111111111100111
111111100111
111111100111
111111100111
111111100111
111111100111
111111100111
111111100111
111111100111
111111100111
111111100111
111111100111
111111100111
111111100111
111111100111
111111100111
111111100111
111111100111
111111100111111111100111
111111100111
111111100111
111111100111
111111100111
111111100111
111111100111
111111100111
111111100111
111111100111
111111100111111111100111
111111100111
111111100111
111111100111
111111100111
111111100111
111111100111111111100111
111111100111
111111100111
111111100111
111111100111
111111100111
111111100111
111111100111
111111100111
111111100111
111111100111
111111100111
111111100111
111111100111
111111100111
111111100111
111111100111
111111100111
111111100111111111100111
111111100111
111111100111
111111100111
111111100111
111111100111
111111100111
111111100111
111111100111
111111100111
111111100111111111100111
111111100111
111111100111
111111100111
111111100111
111111100111
111111100111111111100111
111111100111
111111100111
111111100111
111111100111
111111100111
111111100111
111111100111
111111100111
111111100111
111111100111
111111100111
111111100111
111111100111
111111100111
111111100111
111111100111
111111100111
111111100111111111100111
111111100111
111111100111
111111100111
111111100111
111111100111
111111100111
111111100111
111111100111
111111100111
111111100111111111100111
111111100111
111111100111
111111100111
111111100111
111111100111
111111100111111111100111
111111100111
111111100111
111111100111
111111100111
111111100111
111111100111
111111100111
111111100111
111111100111
111111100111
111111100111
111111100111
111111100111
111111100111
111111100111
111111100111
111111100111
111111100111111111100111
111111100111
111111100111
111111100111
111111100111
111111100111
111111100111
111111100111
111111100111
111111100111
111111100111111111100111
111111100111
111111100111
111111100111
111111100111
111111100111
111111100111111111100111
111111100111
111111100111
111111100111
111111100111
111111100111
111111100111
111111100111
111111100111
111111100111
111111100111
111111100111
111111100111
111111100111
111111100111
111111100111
111111100111
111111100111
111111100111111111100111
111111100111
111111100111
111111100111
111111100111
111111100111
111111100111
111111100111
111111100111
111111100111
111111100111111111100111
111111100111
111111100111
111111100111
111111100111
111111100111
111111100111111111100111
111111100111
111111100111
111111100111
111111100111
111111100111
111111100111
111111100111
111111100111
111111100111
111111100111
111111100111
111111100111
111111100111
111111100111
111111100111
111111100111
111111100111
111111100111111111100111
111111100111
111111100111
111111100111
111111100111
111111100111
111111100111
111111100111
111111100111
111111100111
111111100111111111100111
111111100111
111111100111
111111100111
111111100111
111111100111
111111100111111111100111
111111100111
111111100111
111111100111
111111100111
111111100111
111111100111
111111100111
111111100111
111111100111
111111100111
111111100111
111111100111
111111100111
111111100111
111111100111
111111100111
111111100111
111111100111111111100111
111111100111
111111100111
111111100111
111111100111
111111100111
111111100111
111111100111
111111100111
111111100111
111111100111111111100111
111111100111
111111100111
111111100111
111111100111
111111100111
111111100111111111100111
111111100111
111111100111
111111100111
111111100111
111111100111
111111100111
111111100111
111111100111
111111100111
111111100111
111111100111
111111100111
111111100111
111111100111
111111100111
111111100111
111111100111
111111100111111111100111
111111100111
111111100111
111111100111
111111100111
111111100111
111111100111
111111100111
111111100111
111111100111
111111100111111111100111
111111100111
111111100111
111111100111
111111100111
111111100111
111111100111111111100111
111111100111
111111100111
111111100111
111111100111
111111100111
111111100111
111111100111
111111100111
111111100111
111111100111
111111100111
111111100111
111111100111
111111100111
111111100111
111111100111
111111100111
111111100111111111100111
111111100111
111111100111
111111100111
111111100111
111111100111
111111100111
111111100111
111111100111
111111100111
111111100111111111100111
111111100111
111111100111
111111100111
111111100111
111111100111
111111100111111111100111
111111100111
111111100111
111111100111
111111100111
111111100111
111111100111
111111100111
111111100111
111111100111
111111100111
111111100111
111111100111
111111100111
111111100111
111111100111
111111100111
111111100111
111111100111111111100111
111111100111
111111100111
111111100111
111111100111
111111100111
111111100111
111111100111
111111100111
111111100111
111111100111111111100111
111111100111
111111100111
111111100111
111111100111
111111100111
111111100111111111100111
111111100111
111111100111
111111100111
111111100111
111111100111
111111100111
111111100111
111111100111
111111100111
111111100111
111111100111
111111100111
111111100111
111111100111
111111100111
111111100111
111111100111
111111100111111111100111
111111100111
111111100111
111111100111
111111100111
111111100111
111111100111
111111100111
111111100111
111111100111
111111100111111111100111
111111100111
111111100111
111111100111
111111100111
111111100111
111111100111111111100111
111111100111
111111100111
111111100111
111111100111
111111100111
111111100111
111111100111
111111100111
111111100111
111111100111
111111100111
111111100111
111111100111
111111100111
111111100111
111111100111
111111100111
111111100111111111100111
111111100111
111111100111
111111100111
111111100111
111111100111
111111100111
111111100111
111111100111
111111100111
111111100111111111100111
111111100111
111111100111
111111100111
111111100111
111111100111
111111100111111111100111
111111100111
111111100111
111111100111
111111100111
111111100111
111111100111
111111100111
111111100111
111111100111
111111100111
111111100111
111111100111
111111100111
111111100111
111111100111
111111100111
111111100111
111111100111111111100111
111111100111
111111100111
111111100111
111111100111
111111100111
111111100111
111111100111
111111100111
111111100111
111111100111111111100111
111111100111
111111100111
111111100111
111111100111
111111100111
111111100111111111100111
111111100111
111111100111
111111100111
111111100111
111111100111
111111100111
111111100111
111111100111
111111100111
111111100111
111111100111
111111100111
111111100111
111111100111
111111100111
111111100111
111111100111
111111100111111111100111
111111100111
111111100111
111111100111
111111100111
111111100111
111111100111
111111100111
111111100111
111111100111
111111100111111111100111
111111100111
111111100111
111111100111
111111100111
111111100111
111111100111111111100111
111111100111
111111100111
111111100111
111111100111
111111100111
111111100111
111111100111
111111100111
111111100111
111111100111
111111100111
111111100111
111111100111
111111100111
111111100111
111111100111
111111100111
111111100111111111100111
111111100111
111111100111
111111100111
111111100111
111111100111
111111100111
111111100111
111111100111
111111100111
111111100111111111100111
111111100111
111111100111
111111100111
111111100111
111111100111
111111100111
111111100111
111111100111111111100111
111111100111
111111100111
111111100111111111100111
111111100111
1111111111111