NO ./path_to_the_north_texture
SO ./path_to_the_south_texture
WE ./path_to_the_west_texture
EA ./path_to_the_east_texture
F 220,100,0
C 225,30,0
1111111111111111111111111
1111111111000000000000001
11111111100111111111111011
11111111110011111111111011
10001001111011111111110001
10101000010000000000110011
101000010111100000001100111111
101111110100000000001110000001
1000000101110111111111111111011111111111111111111
1000000101110100000000000000000000000000000000011111111111111
11111100010001111110000000001110000000000000000000000000000011
100010011110010000100000000010100000000000000111000000000000111
10101001111100010110000000001110000000000000000000000000000001
10100001111111110100000000000000000100010010000000000000000001
101111111000000001000000000000000001010100100000000000000000011
100000000000000011000000S0000000000001000000000000000000000001111
10000001111111111000000000000000000000000000000000000000000000011
11111111111111111111111111111111111111111111111111111111111111111
