NO ./textures/north_wall.png            
SO ./textures/south_wall.png
WE ./textures/west_wall.png        
EA ./textures/east_wall.png
C 111, 222, 255
F 220,100,0

1111111111111111111111111
1000000000110000000000001
1011000001110000000000001
100100000000000000000000111111111
111111111011000001110000000000001
100000000011000001110111111111111
1111011111  1111011100000010001
111101111111111111010100100011
1100000011010011 100000010001
100000000010N001  100000010001
10000000001000001101010010001
11000001100011111100101111000111
11110111 1110101 101111010001
11111111 1111111 111111111111