NO ./textures/wall_big.png

SO ./textures/wall_big.png

WE ./textures/wall_big.png

EA ./textures/wall_big.png


F 10,5,0
C 0,0,0


        1111111111111111111111111
        1000000000110000000000001
        1011000001110000000000001
        1001000000000000000000001
111111111011000001110000000000001
100000000011000001110111110111111
1111011111111101110000001000111
1111011111111101110101001000001
110000001101010111000000100001
1000000000000000110000001000001
1000000000000000D00001001000111
110000011101010111100000D000111
 11110111 1110001 1000000000S01
11111111 1111111 1111111111111