NO       ./textures/brickwall11.png

SO   ./textures/brickwall11.png

WE ./textures/brickwall11.png

EA ./textures/brickwall11.png


F 0,11, 0
C 0,0 , 20


111111111111111111111111111111111111
1111000D0000000000000000000011111111
  1X01111000000000110000000000001
   1011 1011000001110000000000001
   101 1001000000000000000000001
1111D1111011000001110000000000001
100000000011000001110111110111111
1111011111111101110000001000111
1111011111111101110101001000001
110000001101010111000000100001
1000000000000000110000001000001
1000000000000000D00001001000111
110000011101010111100000D000111
 11100111 1110001 1000001000S01
1110011 1111111111100111111111
11100011 11111 11 1001111
   10001   11111110011
   11001    111000001111
    110011111100000000111
    11000111111000001111
      11000000000000011
        11111111111111
