NO ./textures/concrete.png

SO ./textures/concrete.png

WE ./textures/concrete.png


EA ./textures/concrete.png


F 64,64,64
C 0,0,0


        1111111111111111111111111
        1000000000110000000000001
        101100000111000000E000001
        1001000000000000000000001
111111111011000001110000000000001
1000000000D1000001110111110111111
1111011111D1110111000000100011111111111111
1111011111D11101110101001000001111D0000001
110000001101010111000000D00000000DD10000011
1000000000000000DD0000001000001111110000001
10000000000000001101010010001111111111D11111
11000001110101011111011110001110000000000001
 11110111 1110001 10111101000100000000000001
11111111 111111011111111111111000000000000001
111111111111111D1111111111111000000000000000011
            111D11111111111000000000000000000011
            10D011111111111111000000000000000000111111111
            1011          1000000000000000000000000001
            1011          10010000000000000000000000001
            1011          11111000000000000000000000011
            1011          11111111001111111111111111111
        11111D11111111111111111111D11111111111111111
011111111110000000000000000000000001111111
1111111111111111111111111111111111111
