NO ./textures/brickwall10.png

SO ./textures/brickwall10.png

WE ./textures/brickwall10.png

EA ./textures/brickwall10.png


F 10,5,0
C 0,0,0

111111111111111111111111111
100000000000000000000000001
101111011111011111011110101
100000010000010000010000001
101111011111011101111011111
100000000000010000000000001
111101111111010111110111101
100101000001010100000100001
100101011101110111011101001
100000000000000000000000001
111111011101011101011111101
100000010000000000010000001
101111011101111011101111101
100001000000000000000000001
111101111011111011111011101
1000000000000100000000000X1
101111011111011101111011101
100000010000000000000010001
111111011111011101111111101
100000000000000D00000000001
111101111101111111101111101
100001000000000N00000000001
111111111111111111111111111
