NO ./textures/test_wall2.png
SO ./textures/test_wall5.png
WE ./textures/test_wall3.png
EA ./textures/brickwall10.png
F 220,100,0
C 111, 222, 122

1111111111111111111111111
1000000000110000000000001
1011000001110000000000001
100100000000000000000000111111111
111111111011000001110000000000001
100000000011000001110111111111111
1111011111  1111011100000010001
111101111111111111010100100011
110000001101S011 100000010001
1000000000100001  100000010001
10000000001000001101010010001
11000001100011111100101111000111
11110111 1110101 101111010001
11111111 1111111 111111111111
