NO ./textures/test_wall2.png
SO ./textures/test_wall5.png
WE ./textures/test_wall3.png
EA ./textures/test_wall4.png
F 220,100,0
C 225,30,0

1111111111111111111111111
1000000000110000000000001
1011000001110000000000001
100100000000000000000000111111111
111111111011000001110000000000001
100000000011000001110111111111111
111101111     1011100000010001
11110111111111111101010010001
110000001101S011  00000010001
1000000000100001   00000010001
10000000001000001101010010001
110000011000111 1 00101111000111
11110111 1110101 101111010001
11111111 1111111 111111111111
